XXXXXXXXXXXXXXXXXXXXXXXXXX
XS...X...X.X.....X...X...X
X...X...XX.X..X..XX..X...X
XX..X..X..X..X..X.X..XX..X
X...X....X..X..XX.X...X..X
X..XX..XX.X..X.X..X.X.X..X
X..X....X..X..X...X..X...X
X..X..XX.X..X..X.XX..X...X
X...XX....XX...XX....XX.EX
XXXXXXXXXXXXXXXXXXXXXXXXXX