XXXXXXXXXXXXXXXXXXX
XS................X
X...........e.....X
X.................X
X.................X
X.................X
X....e......e.....X
X.................X
X................xX
XXXXXXXXXXXXXXXXXXX
sep
XXXXXXXXXXXXXXXXXXX
XE.           .  .X
X.            .  .X
X                .X
X           .    .X
X           .    .X
X..              .X
X    ..   ..     .X
X         ..      X
XXXXXXXXXXXXXXXXXXX
